width=7
height=5
loop=1
next=level15
#######
#r...g#
#.....#
#s...r#
#######
