width=9
height=13
loop=4
next=level1
.........
.........
.........
.........
####.....
#s.##....
##..##...
.##..##..
..##..##.
...##..##
....##..#
.....##g#
......###
