width=7
height=9
loop=8
next=level12
#######
#.s.b.#
#bbb..#
#..b.b#
#bb.bb#
#..b..#
#.bgb.#
#.b.b.#
#######
