width=8
height=5
loop=1
next=done
########
#......#
#s.b.g.#
#......#
########
