width=8
height=8
loop=2
next=level17
########
#b.b.b.#
#.b.b.b#
#bsbgbr#
#.b.b.b#
#b.brb.#
#.b.b.b#
########
