width=10
height=8
loop=4
next=level3
.......###
.#######g#
.#.......#
.#.#######
.#...#....
####.#....
#s...#....
######....
