width=18
height=15
loop=1
next=level16a
..................
##################
#r..............r#
#..r....r....r...#
#.r........g.....#
#................#
#....s.......r...#
#r.......r......r#
#................#
#....r........r..#
#................#
#.r.....r........#
#........r.......#
#r...r........r..#
##################
