width=7
height=5
loop=2
next=level11
#######
#s..b.#
#bbb..#
#...g.#
#######
