width=11
height=9
loop=3
next=level14
####.......
#s.####....
#bb...#....
#..#b##....
#b...#.....
#.b..######
####.....g#
...###...##
.....#####.
