width=10
height=6
loop=4
next=level7
##########
#s.......#
#####.####
...#..#...
...#g##...
...###....
