width=18
height=15
loop=2
next=done
..................
##################
#...............r#
#...b.##r........#
#......#.........#
#.........bb.....#
#........bg......#
#r...r......b....#
###.#............#
#...#............#
#................#
#s...bb..........#
#####............#
#.......r........#
##################
