width=8
height=8
loop=3
next=level6
########
#s.....#
#####.##
...#..#.
..##.##.
..#..#..
..#g##..
..###...
