width=5
height=11
loop=4
next=level2
.....
.....
#####
#s..#
###.#
#...#
#.###
#...#
###.#
#g..#
#####
