width=9
height=8
loop=4
next=level7
#########
#s......#
#####.###
...#..#..
..##.##..
..#..#...
..#g##...
..###....
