width=10
height=8
loop=7
next=level8
.###..###.
.#.####g##
.#.......#
.#.#######
.#...#....
####.#....
#s...#....
######....
