width=8
height=6
loop=3
next=done
########
#s.....#
#..#.#.#
####g..#
...###.#
.....###
