width=12
height=9
loop=4
next=level16
#######.###.
#s....#.#.#.
#...#.###.##
#...#....r.#
#######.####
......#....#
......##.###
.......#g#..
.......###..
