width=15
height=7
loop=3
next=done
###############
#.............#
#...........#.#
#......#....#.#
#.....###...#.#
#.....#g......#
###############
