width=10
height=11
loop=8
next=done
##########
#..b.....#
#........#
#s.......#
#..b.....#
#..b.....#
#........#
#........#
#........#
#g.......#
##########
