width=15
height=6
loop=3
next=testlevel4
###############
#.............#
#...........#.#
#......#....#.#
#.....#g......#
###############
